20x20
WWWWWWWWWWWWWWWWWWWW
W.GFWWWWWWWWWWWWWWWW
W.WWWWWWWWWWWWWWWWWW
W.WWWWWWWWWWWWWWWWWW
W.WWWWWWWWWWWWWWWWWW
W.WWWWWWWWWWWWWWWWWW
W......WWWWWWWWWWWWW
WWWWWW.WWWWWWWWWWWWW
W......WWWWWWWWWWWWW
W.WWWWWWWWWWWWWWWWWW
W.WWWWWWWWWWWWWWWWWW
W.WWWWWWWWWWWWWWWWWW
W.WWWWWWWWWWWWWWWWWW
W.WWWWWWWWWWWWWWWWWW
W.WWWWWWWWWWWWWWWWWW
W.KWWWWWWWWWWWWWWWWW
W.WWWWWWWWWWWWWWWWWW
WOWWWWWWWWWWWWWWWWWW
WWWWWWWWWWWWWWWWWWWW
WWWWWWWWWWWWWWWWWWWW

